40,40
00000100000000E1100001111100001000000100
0010001011111000001100100101000101010010
0100001010010000100000100001000101010010
0000110010110010111001100100000010000010
0101000000100110010001001001110101001000
0100100001000000000101101000011001000000
0001000100010101111000100001000101000010
0010000100010100001000111000000100011011
0100111000010111010001100001110011001010
0010010000010101010011000100001000101010
0100100000010100100000101001000010101110
0110100001100100000000101011100011100000
0010101110001110010001000110101110000000
0110100001000000011000000000101000000011
0100011011111000010001010100100001000000
0110010000001000000000001100100000011101
0000100000001111000011000001100100001000
0000100000000100101010001110000000101010
0001011100000110111000101011100011100000
0010000000000000010010101010000011001000
0011101100000110010110101000110100110010
0000110100000100110011010010001110100100
0011110101101001011001010110111000011001
0001001101000001000100010010001001000011
0010011001011111101110110110101010110011
0010001110100000001010010001100000010001
1110101010101010000111011100101010111101
1000101000101011110111000101101011100100
0010000100101000101010011010001100010101
0100100101101010001000111011010111010100
0011010000101011011001010010000001010001
1001011110011000111010010100000000011000
1100010001110000000010100001000001110001
1001010110111110110100100010000100000100
1011100100000110001110100010001110100000
1001101001010000000000000010010000100010
1101000000110000110100101110011011000111
1001001110000011010101110001000001010101
1010101000001001000101010100011100010000
1000000000010000101101000S01100000100000



0路  1墙  S起点  E终点
