40,40
0000010000000IE1100001111100001000000100
0010001011111D00001100100101000101010010
010000101001IG00100000100001000101010010
000011001011D010111001100100000010000010
010100000010D11001ICF1001001110101001000
010010000100HCCCCCG1D1101000011001000000
0001000100010101111IG0100001000101000010
0010000100010100001D00111000000100011011
010011100001011101IG01100001110011001010
001001000001012101D011000100001000101010
01001000000101221IG000101001000010101110
011010000110012IAG0000101011100011100000
001010111000111D210001000110101110000000
01101000010000IG211000000000101000000011
01000110111110D2210001010100100001000000
01100100000010HCF00000001100100000011101
0000100000001111HCCF11000001100100001000
0000100000000100101D10001110000000101010
0001011100000110111D00101011100011100000
001000000000000001IG10101010000011001000
001110110000011001D110101000110100110010
000011010000010011HF11010010001110100100
0011110101101001211HF1010110111000011001
00012211010000012221HF010010001001000011
001221100101111112111D110110101010110011
001222111212222222101HF10001100000010001
1112121212121212222111D11100101010111101
1222121222121211112111D00101101011100100
221222212212122212121IG11010001100010101
2122122121121212221IAG111011010111010100
2211212222121211211D21010010000001010001
1221211112211222111D100101ICF00000011000
112221222111222IAAAG101ICCG1D00001110001
122121211211111D1121001B001IG00100000100
121112212222211D0011101B001D001110100000
122112122121222HCCCCCCCG001D010000100010
112122222211222211010010111HF11011000111
122122111222221101010111IAF1D00001010101
121212122222122100010121D1HAG11100010000
122222222221222210110122HS21100000100000




0路  1墙  S起点  E终点  2不通路  A右   B下  C左  D上  F右下/上左  G右上/下左  H左上/下右  I左下/上右
