20,20
22222222222221000000
2222SAAAAAAAF1000000
222222222222B1000000
22222222222IG1000000
22222222222B10000000
22222222222HF1000000
2222222222IFHAF00000
2222222222BDIFB00000
2222222222BDBDB00000
2222222222BDBDB00000
2222222222BDBDB00000
2222222222BDBDB00000
2222222222BDBHG00000
2222222222BDB1110000
2222222222BHG1ECF000
2222222222HF1211D000
22222222222HAAAFD000
2222222222222ICGD000
2222222222222HAFD000
222222222222222HG000




0路  1墙  S起点  E终点  2不通路  A右   B下  C左  D上  F右下/上左  G右上/下左  H左上/下右  I左下/上右
